Level,Price,Taste,Dish,Arctic Cod,Cherry Tomato,Rice,Garlic
1,408,125,6,-,-,-,-
2,530,153,6,6,4,4,4
3,652,181,6,9,6,6,6
4,775,209,7,13,10,10,10
5,897,237,7,20,15,15,15
6,1020,265,7,30,22,22,22
7,1142,293,8,45,34,34,34
8,1264,321,8,68,51,51,51
9,1387,349,8,102,76,76,76
10,1509,377,9,153,115,115,115
