Level,Price,Taste,Dish,Longfin Batfish,Orbicular Batfish,Rice,Egg
1,400,150,5,-,-,-,
2,520,183,5,9,9,4,4
3,640,216,5,13,13,6,6
4,760,249,6,20,20,10,10
5,880,282,6,30,30,15,15
6,1000,315,6,45,45,22,22
7,1120,348,6,68,68,34,34
8,1240,381,7,102,102,51,51
9,1360,414,7,153,153,76,76
10,1480,447,7,230,230,115,115
