Level,Price,Taste,Dish,Blobfish,Wheat,Mayonnaise,Sesame Seed
1,375,115,7,-,-,-,-
2,487,138,7,6,4,3,3
3,600,161,8,9,6,4,4
4,712,184,8,13,10,6,6
5,825,207,8,20,15,10,10
6,937,230,9,30,22,15,15
7,1050,253,9,45,34,22,22
8,1162,276,9,68,51,34,34
9,1275,299,10,102,76,51,51
10,1387,322,10,153,115,76,76
