Level,Price,Taste,Dish,Bluefin Tuna Akami,Rice,Egg,Sesame Seed
1,360,130,6,-,-,-,-
2,468,160,6,6,6,3,3
3,576,190,6,9,9,4,4
4,684,220,7,13,13,6,6
5,792,250,7,20,20,10,10
6,900,280,7,30,30,15,15
7,1008,310,8,45,45,22,22
8,1116,340,8,68,68,34,34
9,1224,370,8,102,102,51,51
10,1332,400,9,153,153,76,76
