Level,Price,Taste,Dish,Sailfish Meat,Southern Bull Kelp,Kajime,Soy Sauce
1,425,138,6,-,-,-,-
2,552,156,6,6,4,4,3
3,680,174,6,9,6,6,4
4,807,192,7,13,10,10,6
5,935,210,7,20,15,15,10
6,1062,228,7,30,22,22,15
7,1190,246,8,45,34,34,22
8,1317,264,8,68,51,51,34
9,1445,282,8,102,76,76,51
10,1572,300,9,153,115,115,76
