Level,Price,Taste,Dish,Whiteleg Shrimp,Egg,Mayonnaise,Olive Oil
1,225,105,7,-,-,-,-
2,292,130,7,9,3,3,3
3,360,155,8,13,4,4,4
4,427,180,8,20,6,6,6
5,495,205,8,30,10,10,10
6,562,230,9,45,15,15,15
7,630,255,9,68,22,22,22
8,697,280,9,102,34,34,34
9,765,305,10,153,51,51,51
10,832,330,10,230,76,76,76
