Level,Price,Taste,Dish,Comber,Painted Comber,Egg,Wheat
1,390,150,4,-,-,-,-
2,507,180,4,9,9,4,4
3,624,210,4,13,13,6,6
4,741,240,4,20,20,10,10
5,858,270,5,30,30,15,15
6,975,300,5,45,45,22,22
7,1092,330,5,68,68,34,34
8,1209,360,5,102,102,51,51
9,1326,390,5,153,153,76,76
10,1443,420,6,230,230,115,115
