Level,Price,Taste,Dish,Cookiecutter Shark,Vampire Squid,Barreleye,Kelp
1,395,140,5,-,-,-,-
2,513,160,5,3,3,3,6
3,632,180,5,4,4,4,9
4,750,200,6,6,6,6,13
5,869,220,6,10,10,10,20
6,987,240,6,15,15,15,30
7,1106,260,6,22,22,22,45
8,1224,280,7,34,34,34,68
9,1343,300,7,51,51,51,102
10,1461,320,7,76,76,76,153
