Level,Price,Taste,Dish,Black Tiger Shrimp,Whiteleg Shrimp,Eggplant,Olive Oil
1,400,145,5,-,-,-,-
2,520,180,5,6,6,6,3
3,640,215,5,9,9,9,4
4,760,250,6,13,13,13,6
5,880,285,6,20,20,20,10
6,1000,320,6,30,30,30,15
7,1120,355,6,45,45,45,22
8,1240,390,7,68,68,68,34
9,1360,425,7,102,102,102,51
10,1480,460,7,153,153,153,76
