Level,Price,Taste,Dish,Cucumber,Onion,Carrot,Olive Oil
1,312,153,2,-,-,-,-
2,405,180,2,3,3,3,3
3,499,207,2,4,4,4,4
4,592,234,2,6,6,6,6
5,686,261,2,10,10,10,10
6,780,288,2,15,15,15,15
7,873,315,2,22,22,22,22
8,967,342,2,34,34,34,34
9,1060,369,2,51,51,51,51
10,1154,396,3,76,76,76,76
