Level,Price,Taste,Dish,Starry Skate,Stingray Meat,Marbled Electric Ray Meat,Salt
1,400,180,8,-,-,-,-
2,520,185,8,6,6,6,3
3,640,190,9,9,9,9,4
4,760,195,9,13,13,13,6
5,880,200,10,20,20,20,10
6,1000,205,10,30,30,30,15
7,1120,210,10,45,45,45,22
8,1240,215,11,68,68,68,34
9,1360,220,11,102,102,102,51
10,1480,225,12,153,153,153,76
