Level,Price,Taste,Dish,Dusky Grouper,Cherry Tomato,Salt,Olive Oil
1,400,148,5,-,-,-,-
2,520,168,5,9,6,3,3
3,640,188,5,13,9,4,4
4,760,208,6,20,13,6,6
5,880,228,6,30,20,10,10
6,1000,248,6,45,30,15,15
7,1120,268,6,68,45,22,22
8,1240,288,7,102,68,34,34
9,1360,308,7,153,102,51,51
10,1480,328,7,230,153,76,76
