Level,Price,Taste,Dish,Buckwheat,Eggplant,Carrot,Miso
1,425,173,6,-,-,-,-
2,552,180,6,4,4,3,3
3,680,187,6,6,6,4,4
4,807,194,7,10,10,6,6
5,935,201,7,15,15,10,10
6,1062,208,7,22,22,15,15
7,1190,215,8,34,34,22,22
8,1317,222,8,51,51,34,34
9,1445,229,8,76,76,51,51
10,1572,236,9,115,115,76,76
