Level,Price,Taste,Dish,Falcatus,Seaweed,Buckbean,Miso
1,420,130,5,-,-,-,-
2,546,158,5,6,6,6,3
3,672,186,5,9,9,9,4
4,798,214,6,13,13,13,6
5,924,242,6,20,20,20,10
6,1050,270,6,30,30,30,15
7,1176,298,6,45,45,45,22
8,1302,326,7,68,68,68,34
9,1428,354,7,102,102,102,51
10,1554,382,7,153,153,153,76
