Level,Price,Taste,Dish,Gelatinous Snailfish,Salmon Snailfish,Bean,Cherry Tomato
1,390,110,8,-,-,-,-
2,507,135,8,6,6,4,4
3,624,160,9,9,9,6,6
4,741,185,9,13,13,10,10
5,858,210,10,20,20,15,15
6,975,235,10,30,30,22,22
7,1092,260,10,45,45,34,34
8,1209,285,11,68,68,51,51
9,1326,310,11,102,102,76,76
10,1443,335,12,153,153,115,115
