Level,Price,Taste,Dish,Sally Lightfoot Crab,Rice,Grade A Egg,Black Pepper
1,385,125,7,-,-,-,-
2,500,145,7,4,4,3,3
3,616,165,8,6,6,4,4
4,731,185,8,10,10,6,6
5,847,205,8,15,15,10,10
6,962,225,9,22,22,15,15
7,1078,245,9,34,34,22,22
8,1193,265,9,51,51,34,34
9,1309,285,10,76,76,51,51
10,1424,305,10,115,115,76,76
