Level,Price,Taste,Dish,Cuttlefish,Onion,Olive Oil,Salt
1,400,153,5,-,-,-,-
2,520,176,5,9,6,3,3
3,640,199,5,13,9,4,4
4,760,222,6,20,13,6,6
5,880,245,6,30,20,10,10
6,1000,268,6,45,30,15,15
7,1120,291,6,68,45,22,22
8,1240,314,7,102,68,34,34
9,1360,337,7,153,102,51,51
10,1480,360,7,230,153,76,76
