Level,Price,Taste,Dish,Fangtooth,Habanero,Bladderwrack,Olive Oil
1,410,150,5,-,-,-,-
2,533,180,5,4,4,3,3
3,656,210,5,6,6,4,4
4,779,240,6,10,10,6,6
5,902,270,6,15,15,10,10
6,1025,300,6,22,22,15,15
7,1148,330,6,34,34,22,22
8,1271,360,7,51,51,34,34
9,1394,390,7,76,76,51,51
10,1517,420,7,115,115,76,76
