Level,Price,Taste,Dish,European Lobster,Moray Eel,Turmeric,Olive Oil
1,370,140,6,-,-,-,-
2,481,165,6,4,4,3,3
3,592,190,6,6,6,4,4
4,703,215,7,10,10,6,6
5,814,240,7,15,15,10,10
6,925,265,7,22,22,15,15
7,1036,290,8,34,34,22,22
8,1147,315,8,51,51,34,34
9,1258,340,8,76,76,51,51
10,1369,365,9,115,115,76,76
