Level,Price,Taste,Dish,Great Barracuda,Cherry Tomato,Onion,Mayonnaise
1,425,147,4,-,-,-,-
2,552,172,4,9,3,3,3
3,680,197,4,13,4,4,4
4,807,222,4,20,6,6,6
5,935,247,5,30,10,10,10
6,1062,272,5,45,15,15,15
7,1190,297,5,68,22,22,22
8,1317,322,5,102,34,34,34
9,1445,347,5,153,51,51,51
10,1572,372,6,230,76,76,76
