Level,Price,Taste,Dish,Snub-nosed Spiny Eel,Habanero,Kajime,Soy Sauce
1,425,155,6,-,-,-,-
2,552,175,6,4,4,3,3
3,680,195,6,6,6,4,4
4,807,215,7,10,10,6,6
5,935,235,7,15,15,10,10
6,1062,255,7,22,22,15,15
7,1190,275,8,34,34,22,22
8,1317,295,8,51,51,34,34
9,1445,315,8,76,76,51,51
10,1572,335,9,115,115,76,76
