Level,Price,Taste,Dish,Haddock,Cherry Tomato,Carrot,Olive Oil
1,405,130,6,-,-,-,-
2,526,160,6,6,4,4,3
3,648,190,6,9,6,6,4
4,769,220,7,13,10,10,6
5,891,250,7,20,15,15,10
6,1012,280,7,30,22,22,15
7,1134,310,8,45,34,34,22
8,1255,340,8,68,51,51,34
9,1377,370,8,102,76,76,51
10,1498,400,9,153,115,115,76
