Level,Price,Taste,Dish,Yellowfin Tuna Akami,Rice,Mayonnaise,Sesame Seed
1,265,123,6,-,-,-,-
2,344,148,6,6,6,3,3
3,424,173,6,9,9,4,4
4,503,198,7,13,13,6,6
5,583,223,7,20,20,10,10
6,662,248,7,30,30,15,15
7,742,273,8,45,45,22,22
8,821,298,8,68,68,34,34
9,901,323,8,102,102,51,51
10,980,348,9,153,153,76,76
