Level,Price,Taste,Dish,Bluefin Tuna Chutoro,Habanero,Sea Grape,Sesame Seed
1,395,170,5,-,-,-,-
2,513,190,5,6,4,4,3
3,632,210,5,9,6,6,4
4,750,230,6,13,10,10,6
5,869,250,6,20,15,15,10
6,987,270,6,30,22,22,15
7,1106,290,6,45,34,34,22
8,1224,310,7,68,51,51,34
9,1343,330,7,102,76,76,51
10,1461,350,7,153,115,115,76
