Level,Price,Taste,Dish,Humboldt Squid Meat,White Shrimp,Wheat,Garlic
1,420,150,7,-,-,-,-
2,546,175,7,3,6,6,6
3,672,200,8,4,9,9,9
4,798,225,8,6,13,13,13
5,924,250,8,10,20,20,20
6,1050,275,9,15,30,30,30
7,1176,300,9,22,45,45,45
8,1302,325,9,34,68,68,68
9,1428,350,10,51,102,102,102
10,1554,375,10,76,153,153,153
