Level,Price,Taste,Dish,Grade A Egg,Rice,Sea Grape,Soy Sauce
1,400,170,6,-,-,-,-
2,520,180,6,3,4,4,3
3,640,190,6,4,6,6,4
4,760,200,7,6,10,10,6
5,880,210,7,10,15,15,10
6,1000,220,7,15,22,22,15
7,1120,230,8,22,34,34,22
8,1240,240,8,34,51,51,34
9,1360,250,8,51,76,76,51
10,1480,260,9,76,115,115,76
