Level,Price,Taste,Dish,Black Tiger Shrimp,Whiteleg Shrimp,Wheat,Olive Oil
1,375,125,7,-,-,-,-
2,487,145,7,9,9,4,3
3,600,165,8,13,13,6,4
4,712,185,8,20,20,10,6
5,825,205,8,30,30,15,10
6,937,225,9,45,45,22,15
7,1050,245,9,68,68,34,22
8,1162,265,9,102,102,51,34
9,1275,285,10,153,153,76,51
10,1387,305,10,230,230,115,76
