Level,Price,Taste,Dish,Longspine Squirrelfish,Clearfin Lionfish,Blackfin Barracuda,Bladderwrack
1,405,135,6,-,-,-,-
2,526,160,6,6,6,6,3
3,648,185,6,9,9,9,4
4,769,210,7,13,13,13,6
5,891,235,7,20,20,20,10
6,1012,260,7,30,30,30,15
7,1134,285,8,45,45,45,22
8,1255,310,8,68,68,68,34
9,1377,335,8,102,102,102,51
10,1498,360,9,153,153,153,76
