Level,Price,Taste,Dish,Narrow-Barred Spanish Mackerel,Egg,Rice,Garlic
1,390,130,5,-,-,-,-
2,507,156,5,9,4,4,4
3,624,182,5,13,6,6,6
4,741,208,6,20,10,10,10
5,858,234,6,30,15,15,15
6,975,260,6,45,22,22,22
7,1092,286,6,68,34,34,34
8,1209,312,7,102,51,51,51
9,1326,338,7,153,76,76,76
10,1443,364,7,230,115,115,115
