Level,Price,Taste,Dish,Narwhal Meat,Carrot,Buckbean,Miso
1,400,150,8,-,-,-,-
2,520,180,8,6,4,4,3
3,640,210,9,9,6,6,4
4,760,240,9,13,10,10,6
5,880,270,10,20,15,15,10
6,1000,300,10,30,22,22,15
7,1120,330,10,45,34,34,22
8,1240,360,11,68,51,51,34
9,1360,390,11,102,76,76,51
10,1480,420,12,153,115,115,76
