Level,Price,Taste,Dish,Eggplant,Garlic,Olive Oil,Miso
1,415,155,3,-,-,-,-
2,539,173,3,3,3,3,3
3,664,191,3,4,4,4,4
4,788,209,3,6,6,6,6
5,913,227,3,10,10,10,10
6,1037,245,3,15,15,15,15
7,1162,263,4,22,22,22,22
8,1286,281,4,34,34,34,34
9,1411,299,4,51,51,51,51
10,1535,317,4,76,76,76,76
