Level,Price,Taste,Dish,Peacock Squid,Egg,Garlic,Black Pepper
1,410,135,5,-,-,-,-
2,533,160,5,6,4,4,3
3,656,185,5,9,6,6,4
4,779,210,6,13,10,10,6
5,902,235,6,20,15,15,10
6,1025,260,6,30,22,22,15
7,1148,285,6,45,34,34,22
8,1271,310,7,68,51,51,34
9,1394,335,7,102,76,76,51
10,1517,360,7,153,115,115,76
