Level,Price,Taste,Dish,Cucumber,Eggplant,Carrot,Black Vinegar
1,316,157,2,-,-,-,-
2,410,180,2,3,3,3,3
3,505,203,2,4,4,4,4
4,600,226,2,6,6,6,6
5,695,249,2,10,10,10,10
6,790,272,2,15,15,15,15
7,884,295,2,22,22,22,22
8,979,318,2,34,34,34,34
9,1074,341,2,51,51,51,51
10,1169,364,3,76,76,76,76
