Level,Price,Taste,Dish,Pikaia,Grade A Egg,Wheat,Southern Bull Kelp
1,420,135,7,-,-,-,-
2,546,160,7,6,3,4,6
3,672,185,8,9,4,6,9
4,798,210,8,13,6,10,13
5,924,235,8,20,10,15,20
6,1050,260,9,30,15,22,30
7,1176,285,9,45,22,34,45
8,1302,310,9,68,34,51,68
9,1428,335,10,102,51,76,102
10,1554,360,10,153,76,115,153
