Level,Price,Taste,Dish,Striped Catfish,Wheat,Onion,Bean
1,385,150,5,-,-,-,-
2,500,180,5,9,4,4,4
3,616,210,5,13,6,6,6
4,731,240,6,20,10,10,10
5,847,270,6,30,15,15,15
6,962,300,6,45,22,22,22
7,1078,330,6,68,34,34,34
8,1193,360,7,102,51,51,51
9,1309,390,7,153,76,76,76
10,1424,420,7,230,115,115,115
