Level,Price,Taste,Dish,Longspine Porcupinefish,Starry Puffer,Egg,Bladderwrack
1,420,150,6,-,-,-,-
2,546,180,6,6,6,3,3
3,672,210,6,9,9,4,4
4,798,240,7,13,13,6,6
5,924,270,7,20,20,10,10
6,1050,300,7,30,30,15,15
7,1176,330,8,45,45,22,22
8,1302,360,8,68,68,34,34
9,1428,390,8,102,102,51,51
10,1554,420,9,153,153,76,76
