Level,Price,Taste,Dish,Whiteleg Shrimp,Rice,Egg,Soy Sauce
1,400,148,6,-,-,-,-
2,520,176,6,6,4,4,3
3,640,204,6,9,6,6,4
4,760,232,7,13,10,10,6
5,880,260,7,20,15,15,10
6,1000,288,7,30,22,22,15
7,1120,316,8,45,34,34,22
8,1240,344,8,68,51,51,34
9,1360,372,8,102,76,76,51
10,1480,400,9,153,115,115,76
