Level,Price,Taste,Dish,Clownfish,Pyramid Butterflyfish,Blue Tang,Garlic
1,400,173,6,-,-,-,-
2,520,180,6,9,9,9,6
3,640,187,6,13,13,13,9
4,760,194,7,20,20,20,13
5,880,201,7,30,30,30,20
6,1000,208,7,45,45,45,30
7,1120,215,8,68,68,68,45
8,1240,222,8,102,102,102,68
9,1360,229,8,153,153,153,102
10,1480,236,9,230,230,230,153
