Level,Price,Taste,Dish,Long-Snouted Seahorse,Cherry Tomato,Sea Grape,Olive Oil
1,400,160,4,-,-,-,-
2,520,175,4,6,4,4,3
3,640,190,4,9,6,6,4
4,760,205,4,13,10,10,6
5,880,220,5,20,15,15,10
6,1000,235,5,30,22,22,15
7,1120,250,5,45,34,34,22
8,1240,265,5,68,51,51,34
9,1360,280,5,102,76,76,51
10,1480,295,6,153,115,115,76
