Level,Price,Taste,Dish,Waptia Fieldensis,Cucumber,Black Coral,Black Vinegar
1,425,150,5,-,-,-,-
2,552,180,5,6,4,6,3
3,680,210,5,9,6,9,4
4,807,240,6,13,10,13,6
5,935,270,6,20,15,20,10
6,1062,300,6,30,22,30,15
7,1190,330,6,45,34,45,22
8,1317,360,7,68,51,68,34
9,1445,390,7,102,76,102,51
10,1572,420,7,153,115,153,76
