Level,Price,Taste,Dish,Barrel Jellyfish,Fried Egg Jellyfish,Garlic,Black Coral
1,400,163,4,-,-,-,-
2,520,178,4,9,9,4,4
3,640,193,4,13,13,6,6
4,760,208,4,20,20,10,10
5,880,223,5,30,30,15,15
6,1000,238,5,45,45,22,22
7,1120,253,5,68,68,34,34
8,1240,268,5,102,102,51,51
9,1360,283,5,153,153,76,76
10,1480,298,6,230,230,115,115
