Level,Price,Taste,Dish,Blacktip Shark Meat,Copper Shark Meat,Wheat,Olive Oil
1,400,155,6,-,-,-,
2,520,180,6,6,6,3,3
3,640,205,6,9,9,4,4
4,760,230,7,13,13,6,6
5,880,255,7,20,20,10,10
6,1000,280,7,30,30,15,15
7,1120,305,8,45,45,22,22
8,1240,330,8,68,68,34,34
9,1360,355,8,102,102,51,51
10,1480,380,9,153,153,76,76
