Level,Price,Taste,Dish,Golden King Crab,Snow Crab,Horsehair Crab,Soy Sauce
1,435,190,4,-,-,-,-
2,565,225,4,4,4,4,3
3,716,260,4,6,6,6,4
4,826,295,4,10,10,10,6
5,957,330,5,15,15,15,10
6,1087,365,5,22,22,22,15
7,1218,400,5,34,34,34,22
8,1348,435,5,51,51,51,34
9,1479,470,5,76,76,76,51
10,1609,505,6,115,115,115,76
