Level,Price,Taste,Dish,Spear Squid,Buckwheat,Egg,Carrot
1,425,166,6,-,-,-,-
2,552,180,6,6,4,3,3
3,680,194,6,9,6,4,4
4,807,208,7,13,10,6,6
5,935,222,7,20,15,10,10
6,1062,236,7,30,22,15,15
7,1190,250,8,45,34,22,22
8,1317,264,8,68,51,34,34
9,1445,278,8,102,76,51,51
10,1572,292,9,153,115,76,76
