Level,Price,Taste,Dish,Black Tiger Shrimp,Whiteleg Shrimp,Rice,Olive Oil
1,380,110,1,-,-,-,-
2,494,133,1,4,4,3,3
3,608,156,1,6,6,4,4
4,722,179,1,10,10,6,6
5,836,202,1,15,15,10,10
6,650,225,1,22,22,15,15
7,1064,248,1,34,34,22,22
8,1178,271,1,51,51,34,34
9,1292,294,1,76,76,51,51
10,1406,317,1,115,115,76,76
