Level,Price,Taste,Dish,Bluespotted Stargazer,Wheat,Egg,Olive Oil
1,390,125,4,-,-,-,-
2,507,155,4,3,3,3,3
3,624,185,4,4,4,4,4
4,741,215,4,6,6,6,6
5,858,245,5,10,10,10,10
6,975,275,5,15,15,15,15
7,1092,305,5,22,22,22,22
8,1209,335,5,34,34,34,34
9,1326,365,5,51,51,51,51
10,1443,395,6,76,76,76,76
