Level,Price,Taste,Dish,Peacock Squid,Vampire Squid,Cuttlefish,Salt
1,400,155,8,-,-,-,-
2,520,175,8,6,6,6,3
3,640,195,9,9,9,9,4
4,760,215,9,13,13,13,6
5,880,235,10,20,20,20,10
6,1000,255,10,30,30,30,15
7,1120,275,10,45,45,45,22
8,1240,295,11,68,68,68,34
9,1360,315,11,102,102,102,51
10,1480,335,12,153,153,153,76
