Level,Price,Taste,Dish,Titan Triggerfish,Harlequin Hind,Coral Trout,Rice
1,375,130,6,-,-,-,-
2,487,154,6,6,6,6,6
3,600,178,6,9,9,9,9
4,712,202,7,13,13,13,13
5,825,226,7,20,20,20,20
6,937,250,7,30,30,30,30
7,1050,274,8,45,45,45,45
8,1162,298,8,68,68,68,68
9,1275,322,8,102,102,102,102
10,1387,346,9,153,153,153,153
