Level,Price,Taste,Dish,Coral Trout,Sea Grape,Rice,Soy Sauce
1,175,110,5,-,-,-,-
2,227,130,5,6,3,3,3
3,280,150,5,9,4,4,4
4,332,170,6,13,6,6,6
5,385,190,6,20,10,10,10
6,437,210,6,30,15,15,15
7,490,230,6,45,22,22,22
8,542,250,7,68,34,34,34
9,595,270,7,102,51,51,51
10,647,290,7,153,76,76,76
