Level,Price,Taste,Dish,Atlantic Mackerel,Buckwheat,Seaweed,Soy Sauce
1,425,170,6,-,-,-,-
2,552,180,6,6,4,3,3
3,680,190,6,9,6,4,4
4,807,200,7,13,10,6,6
5,935,210,7,20,15,10,10
6,1062,220,7,30,22,15,15
7,1190,230,8,45,34,22,22
8,1317,240,8,68,51,34,34
9,1445,250,8,102,76,51,51
10,1572,260,9,153,115,76,76
