Level,Price,Taste,Dish,Rainbow Wrasse,Ornate Wrasse,Bean,Curry Block
1,400,150,4,-,-,-,-
2,520,170,4,9,9,3,3
3,640,190,4,13,13,4,4
4,760,210,4,20,20,6,6
5,880,230,5,30,30,10,10
6,1000,250,5,45,45,15,15
7,1120,270,5,68,68,22,22
8,1240,290,5,102,102,34,34
9,1360,310,5,153,153,51,51
10,1480,330,6,230,230,76,76
